20
10
MMMMMMMMMMMMMMMMMMMM
M_______T__________M
M___MMMMMMMMMMM____M
M___M_____B__K__M__M
M__RRRRR___________M
M___M_______P_V__M_M
M___M___H_____V_M__M
M___M_S___P___V__M_M
M__________________M
MMMMMMMMMMMMMMMMMMMM


